municipio,año,mes,hombres,mujeres,total
1,2020,1,2,2,4
1,2020,2,1,1,2
1,2020,3,0,1,1
1,2020,5,2,3,5
1,2020,6,2,2,4
1,2020,7,1,1,2
1,2020,8,0,1,1
1,2020,9,3,2,5
1,2020,10,1,2,3
1,2020,11,3,1,4
1,2020,12,1,0,1
2,2020,1,45,49,94
2,2020,2,51,44,95
2,2020,3,42,37,79
2,2020,4,38,41,79
2,2020,5,44,39,83
2,2020,6,40,31,71
2,2020,7,45,48,93
2,2020,8,50,44,94
2,2020,9,56,48,104
2,2020,10,49,54,103
2,2020,11,38,36,74
2,2020,12,48,37,85
3,2020,1,12,12,24
3,2020,2,13,14,27
3,2020,3,13,9,22
3,2020,4,6,13,19
3,2020,5,12,9,21
3,2020,6,12,7,19
3,2020,7,22,19,41
3,2020,8,17,16,33
3,2020,9,14,15,29
3,2020,10,20,15,35
3,2020,11,16,7,23
3,2020,12,16,13,29
4,2020,1,1,10,11
4,2020,2,3,3,6
4,2020,3,4,2,6
4,2020,4,8,8,16
4,2020,5,4,6,10
4,2020,6,3,5,8
4,2020,7,11,9,20
4,2020,8,4,0,4
4,2020,9,8,5,13
4,2020,10,7,5,12
4,2020,11,7,6,13
4,2020,12,9,11,20
5,2020,1,1,1,2
5,2020,2,0,1,1
5,2020,3,3,1,4
5,2020,4,0,1,1
5,2020,5,1,3,4
5,2020,6,1,1,2
5,2020,7,3,2,5
5,2020,8,1,3,4
5,2020,9,6,1,7
5,2020,10,3,4,7
5,2020,11,0,3,3
5,2020,12,3,2,5
6,2020,1,0,2,2
6,2020,2,1,2,3
6,2020,3,1,1,2
6,2020,7,2,2,4
6,2020,8,1,0,1
6,2020,9,0,2,2
6,2020,10,2,0,2
6,2020,11,2,0,2
6,2020,12,3,0,3
8,2020,2,3,0,3
8,2020,4,0,1,1
8,2020,5,0,1,1
8,2020,6,1,0,1
8,2020,7,0,2,2
8,2020,8,0,1,1
8,2020,9,1,0,1
8,2020,10,0,2,2
9,2020,8,0,2,2
9,2020,10,1,0,1
9,2020,11,0,2,2
10,2020,1,1,0,1
10,2020,3,0,1,1
10,2020,4,1,0,1
10,2020,5,1,1,2
10,2020,6,1,1,2
10,2020,9,0,3,3
10,2020,10,0,1,1
10,2020,11,1,0,1
10,2020,12,2,2,4
11,2020,1,1,0,1
11,2020,2,1,2,3
11,2020,3,3,1,4
11,2020,4,1,0,1
11,2020,5,1,0,1
11,2020,7,1,2,3
11,2020,8,1,1,2
11,2020,9,1,2,3
11,2020,10,0,3,3
11,2020,12,2,0,2
12,2020,1,10,9,19
12,2020,2,12,17,29
12,2020,3,15,14,29
12,2020,4,14,11,25
12,2020,5,22,14,36
12,2020,6,14,16,30
12,2020,7,15,25,40
12,2020,8,13,23,36
12,2020,9,22,11,33
12,2020,10,15,15,30
12,2020,11,22,16,38
12,2020,12,20,19,39
13,2020,1,1,1,2
13,2020,2,0,2,2
13,2020,3,4,4,8
13,2020,4,3,1,4
13,2020,5,3,2,5
13,2020,6,1,3,4
13,2020,7,4,4,8
13,2020,8,0,1,1
13,2020,9,2,6,8
13,2020,10,2,2,4
13,2020,11,1,2,3
13,2020,12,2,1,3
14,2020,1,4,0,4
14,2020,2,0,2,2
14,2020,3,7,7,14
14,2020,4,1,2,3
14,2020,5,4,3,7
14,2020,6,2,4,6
14,2020,7,3,1,4
14,2020,8,5,5,10
14,2020,9,1,4,5
14,2020,10,2,3,5
14,2020,11,4,6,10
14,2020,12,3,3,6
15,2020,2,2,0,2
15,2020,3,2,0,2
15,2020,4,2,1,3
15,2020,5,1,3,4
15,2020,6,0,1,1
15,2020,7,1,2,3
15,2020,9,1,2,3
15,2020,10,1,1,2
15,2020,11,0,1,1
15,2020,12,3,0,3
16,2020,1,2,1,3
16,2020,2,6,0,6
16,2020,3,2,3,5
16,2020,4,1,1,2
16,2020,5,1,2,3
16,2020,6,4,4,8
16,2020,7,2,2,4
16,2020,8,5,3,8
16,2020,9,2,4,6
16,2020,10,1,3,4
16,2020,11,3,2,5
16,2020,12,2,4,6
17,2020,1,35,40,75
17,2020,2,34,32,66
17,2020,3,26,23,49
17,2020,4,21,36,57
17,2020,5,18,25,43
17,2020,6,27,21,48
17,2020,7,36,27,63
17,2020,8,35,25,60
17,2020,9,39,36,75
17,2020,10,32,19,51
17,2020,11,29,27,56
17,2020,12,31,30,61
18,2020,1,260,229,489
18,2020,2,203,188,391
18,2020,3,199,197,396
18,2020,4,148,171,319
18,2020,5,165,151,316
18,2020,6,195,145,340
18,2020,7,217,197,414
18,2020,8,225,254,479
18,2020,9,286,235,521
18,2020,10,256,247,503
18,2020,11,229,219,448
18,2020,12,218,246,464
19,2020,1,17,24,41
19,2020,2,25,22,47
19,2020,3,23,23,46
19,2020,4,21,22,43
19,2020,5,20,27,47
19,2020,6,18,21,39
19,2020,7,10,30,40
19,2020,8,27,29,56
19,2020,9,34,28,62
19,2020,10,25,26,51
19,2020,11,25,24,49
19,2020,12,27,24,51
20,2020,1,4,4,8
20,2020,2,8,1,9
20,2020,3,4,6,10
20,2020,4,4,3,7
20,2020,5,3,2,5
20,2020,6,3,3,6
20,2020,7,1,4,5
20,2020,8,1,6,7
20,2020,9,7,8,15
20,2020,10,3,1,4
20,2020,11,5,4,9
20,2020,12,3,1,4
21,2020,1,1,4,5
21,2020,2,2,3,5
21,2020,3,4,6,10
21,2020,4,8,3,11
21,2020,5,3,7,10
21,2020,6,5,5,10
21,2020,7,10,8,18
21,2020,8,11,9,20
21,2020,9,6,19,25
21,2020,10,13,15,28
21,2020,11,12,8,20
21,2020,12,8,9,17
22,2020,1,1,1,2
22,2020,2,0,1,1
22,2020,3,1,0,1
22,2020,4,1,0,1
22,2020,5,1,0,1
22,2020,6,2,1,3
22,2020,7,1,0,1
22,2020,8,1,0,1
22,2020,9,1,1,2
22,2020,10,2,2,4
22,2020,12,0,1,1
23,2020,1,5,1,6
23,2020,2,3,2,5
23,2020,3,2,0,2
23,2020,4,3,1,4
23,2020,6,2,2,4
23,2020,7,3,1,4
23,2020,8,5,6,11
23,2020,9,2,3,5
23,2020,10,2,6,8
23,2020,11,2,3,5
23,2020,12,1,6,7
24,2020,1,0,1,1
24,2020,3,1,1,2
24,2020,7,0,1,1
24,2020,10,0,2,2
25,2020,1,36,26,62
25,2020,2,33,27,60
25,2020,3,41,41,82
25,2020,4,36,27,63
25,2020,5,36,27,63
25,2020,6,35,30,65
25,2020,7,39,31,70
25,2020,8,40,48,88
25,2020,9,40,65,105
25,2020,10,47,54,101
25,2020,11,31,46,77
25,2020,12,32,32,64
26,2020,1,31,34,65
26,2020,2,35,23,58
26,2020,3,29,33,62
26,2020,4,29,18,47
26,2020,5,21,27,48
26,2020,6,21,26,47
26,2020,7,29,40,69
26,2020,8,19,36,55
26,2020,9,40,56,96
26,2020,10,34,35,69
26,2020,11,28,31,59
26,2020,12,29,32,61
27,2020,1,10,10,20
27,2020,2,9,10,19
27,2020,3,11,9,20
27,2020,4,15,6,21
27,2020,5,14,9,23
27,2020,6,16,8,24
27,2020,7,13,14,27
27,2020,8,12,10,22
27,2020,9,13,13,26
27,2020,10,18,7,25
27,2020,11,14,18,32
27,2020,12,17,10,27
28,2020,3,1,0,1
28,2020,5,1,0,1
28,2020,6,0,1,1
28,2020,7,1,0,1
28,2020,8,1,0,1
28,2020,12,2,0,2
29,2020,1,98,95,193
29,2020,2,78,93,171
29,2020,3,92,83,175
29,2020,4,68,46,114
29,2020,5,68,60,128
29,2020,6,66,76,142
29,2020,7,92,74,166
29,2020,8,88,95,183
29,2020,9,90,91,181
29,2020,10,106,70,176
29,2020,11,95,97,192
29,2020,12,88,105,193
30,2020,1,487,452,939
30,2020,2,401,392,793
30,2020,3,385,374,759
30,2020,4,321,302,623
30,2020,5,351,345,696
30,2020,6,380,374,754
30,2020,7,432,416,848
30,2020,8,456,448,904
30,2020,9,544,499,1043
30,2020,10,480,461,941
30,2020,11,458,433,891
30,2020,12,436,379,815
31,2020,3,0,4,4
31,2020,4,3,0,3
31,2020,5,1,1,2
31,2020,6,1,1,2
31,2020,7,0,1,1
31,2020,8,0,1,1
31,2020,9,2,1,3
31,2020,10,1,2,3
31,2020,11,0,1,1
31,2020,12,1,1,2
32,2020,7,0,2,2
32,2020,9,0,2,2
32,2020,10,0,1,1
32,2020,12,2,0,2
33,2020,1,52,47,99
33,2020,2,44,34,78
33,2020,3,41,51,93
33,2020,4,37,34,71
33,2020,5,33,28,61
33,2020,6,47,39,86
33,2020,7,52,46,98
33,2020,8,61,46,107
33,2020,9,60,58,118
33,2020,10,62,52,114
33,2020,11,44,46,90
33,2020,12,51,43,94
34,2020,1,1,0,1
34,2020,11,1,0,1
35,2020,1,9,7,16
35,2020,2,7,8,15
35,2020,3,10,4,14
35,2020,4,4,5,9
35,2020,5,8,5,13
35,2020,6,10,8,18
35,2020,7,6,5,11
35,2020,8,7,7,14
35,2020,9,8,9,17
35,2020,10,2,10,12
35,2020,11,5,8,13
35,2020,12,9,7,16
36,2020,1,24,18,42
36,2020,2,11,13,24
36,2020,3,12,16,28
36,2020,4,20,9,29
36,2020,5,18,22,40
36,2020,6,21,21,42
36,2020,7,21,26,47
36,2020,8,22,26,48
36,2020,9,31,31,62
36,2020,10,21,23,44
36,2020,11,26,20,46
36,2020,12,21,21,42
37,2020,1,0,1,1
37,2020,3,2,0,2
37,2020,4,2,2,4
37,2020,5,4,0,4
37,2020,6,1,2,3
37,2020,7,1,4,5
37,2020,8,1,1,2
37,2020,9,1,3,4
37,2020,10,2,3,5
37,2020,11,2,2,4
37,2020,12,0,3,3
38,2020,1,2,1,3
38,2020,2,5,1,6
38,2020,3,4,4,8
38,2020,4,3,3,6
38,2020,5,5,4,9
38,2020,6,1,9,10
38,2020,7,3,1,4
38,2020,8,3,9,12
38,2020,9,5,3,8
38,2020,10,6,3,9
38,2020,11,3,5,8
38,2020,12,7,2,9
39,2020,1,2,1,3
39,2020,2,0,1,1
39,2020,3,4,4,8
39,2020,4,2,1,3
39,2020,5,2,5,7
39,2020,6,1,6,7
39,2020,7,4,8,12
39,2020,8,7,1,8
39,2020,9,2,2,4
39,2020,10,2,7,9
39,2020,11,4,2,6
39,2020,12,5,3,8
40,2020,1,1,0,1
40,2020,2,1,0,1
40,2020,3,3,4,7
40,2020,4,1,0,1
40,2020,5,1,1,2
40,2020,6,2,1,3
40,2020,7,1,1,2
40,2020,9,0,3,3
40,2020,10,1,1,2
40,2020,12,1,1,2
41,2020,1,7,5,12
41,2020,2,5,11,16
41,2020,3,5,8,13
41,2020,4,7,1,8
41,2020,5,10,3,13
41,2020,6,6,12,18
41,2020,7,6,4,10
41,2020,8,9,10,19
41,2020,9,9,6,15
41,2020,10,12,4,16
41,2020,11,8,10,18
41,2020,12,9,15,24
42,2020,1,112,109,221
42,2020,2,99,100,199
42,2020,3,94,97,191
42,2020,4,93,93,186
42,2020,5,84,84,168
42,2020,6,111,101,212
42,2020,7,106,110,216
42,2020,8,130,113,243
42,2020,9,134,134,268
42,2020,10,140,142,282
42,2020,11,117,95,212
42,2020,12,115,121,236
43,2020,1,123,122,245
43,2020,2,143,115,258
43,2020,3,124,109,233
43,2020,4,144,115,259
43,2020,5,157,128,285
43,2020,6,132,160,292
43,2020,7,149,143,292
43,2020,8,159,144,303
43,2020,9,162,163,325
43,2020,10,153,142,295
43,2020,11,141,130,271
43,2020,12,160,153,313
44,2020,1,1,0,1
44,2020,3,0,1,1
44,2020,5,0,1,1
44,2020,6,1,0,1
44,2020,9,1,0,1
44,2020,10,2,1,3
44,2020,11,0,2,2
45,2020,1,0,2,2
45,2020,2,0,1,1
45,2020,3,1,2,3
45,2020,4,1,1,2
45,2020,5,1,2,3
45,2020,6,1,0,1
45,2020,7,1,2,3
45,2020,8,2,1,3
45,2020,9,1,6,7
45,2020,10,1,1,2
45,2020,11,1,0,1
45,2020,12,3,2,5
46,2020,1,2,2,4
46,2020,2,3,2,5
46,2020,3,2,2,4
46,2020,4,1,4,5
46,2020,5,4,2,6
46,2020,6,4,2,6
46,2020,7,4,0,4
46,2020,8,3,1,4
46,2020,9,2,2,4
46,2020,10,0,3,3
46,2020,11,2,1,3
46,2020,12,1,2,3
47,2020,1,8,12,20
47,2020,2,13,8,21
47,2020,3,14,17,31
47,2020,4,20,16,36
47,2020,5,16,14,30
47,2020,6,22,22,44
47,2020,7,26,22,48
47,2020,8,19,22,41
47,2020,9,31,20,51
47,2020,10,23,32,55
47,2020,11,24,26,50
47,2020,12,34,28,62
48,2020,1,55,27,82
48,2020,2,29,34,63
48,2020,3,32,42,74
48,2020,4,38,42,80
48,2020,5,35,26,61
48,2020,6,24,31,55
48,2020,7,45,33,78
48,2020,8,40,33,73
48,2020,9,42,47,89
48,2020,10,43,48,91
48,2020,11,37,36,73
48,2020,12,29,42,71
49,2020,1,1,2,3
49,2020,2,2,3,5
49,2020,4,2,2,4
49,2020,5,1,0,1
49,2020,6,3,1,4
49,2020,7,1,1,2
49,2020,8,1,1,2
49,2020,9,5,2,7
49,2020,10,4,1,5
49,2020,11,3,4,7
49,2020,12,4,3,7
50,2020,1,1,0,1
50,2020,2,1,0,1
50,2020,3,0,1,1
50,2020,6,1,2,3
50,2020,7,3,0,3
50,2020,8,3,5,8
50,2020,9,4,0,4
50,2020,10,0,1,1
50,2020,11,2,3,5
50,2020,12,1,2,3
51,2020,1,2,1,3
51,2020,2,2,2,4
51,2020,3,7,3,10
51,2020,4,2,3,5
51,2020,5,2,3,5
51,2020,6,4,1,5
51,2020,7,2,3,5
51,2020,8,4,2,6
51,2020,9,2,3,5
51,2020,10,3,4,7
51,2020,11,5,5,10
51,2020,12,3,5,8
52,2020,1,3,2,5
52,2020,3,1,0,1
52,2020,5,1,1,2
52,2020,7,0,2,2
52,2020,8,0,1,1
52,2020,10,2,2,4
55,2020,1,104,111,215
55,2020,2,111,113,224
55,2020,3,113,87,200
55,2020,4,98,92,190
55,2020,5,96,100,196
55,2020,6,110,118,228
55,2020,7,140,147,287
55,2020,8,155,131,286
55,2020,9,140,129,269
55,2020,10,125,126,251
55,2020,11,148,133,281
55,2020,12,112,126,238
56,2020,1,7,7,14
56,2020,2,10,10,20
56,2020,3,14,20,34
56,2020,4,10,13,23
56,2020,5,13,7,20
56,2020,6,13,9,22
56,2020,7,12,10,22
56,2020,8,16,13,29
56,2020,9,13,11,24
56,2020,10,13,15,28
56,2020,11,19,14,33
56,2020,12,13,13,26
57,2020,2,1,1,2
57,2020,3,0,2,2
57,2020,4,1,1,2
57,2020,5,0,1,1
57,2020,6,1,0,1
57,2020,7,0,3,3
57,2020,8,0,1,1
57,2020,9,2,0,2
57,2020,11,4,1,5
57,2020,12,1,0,1
58,2020,1,9,10,19
58,2020,2,10,13,23
58,2020,3,4,6,10
58,2020,4,5,8,13
58,2020,5,10,6,16
58,2020,6,8,8,16
58,2020,7,15,9,24
58,2020,8,14,13,27
58,2020,9,11,13,24
58,2020,10,12,7,19
58,2020,11,12,6,18
58,2020,12,8,10,18
59,2020,1,0,1,1
59,2020,2,0,1,1
59,2020,3,0,3,3
59,2020,4,1,2,3
59,2020,5,1,1,2
59,2020,6,3,1,4
59,2020,7,4,3,7
59,2020,8,2,2,4
59,2020,9,2,2,4
59,2020,10,1,3,4
59,2020,11,1,3,4
59,2020,12,1,3,4
60,2020,4,1,0,1
60,2020,8,0,1,1
60,2020,11,1,0,1
61,2020,1,3,1,4
61,2020,2,1,0,1
61,2020,3,2,2,4
61,2020,4,0,1,1
61,2020,5,2,3,5
61,2020,6,2,3,5
61,2020,7,2,3,5
61,2020,8,0,1,1
61,2020,9,4,3,7
61,2020,10,5,1,6
61,2020,11,2,3,5
61,2020,12,7,3,10
62,2020,1,0,1,1
62,2020,2,1,1,2
62,2020,4,2,1,3
62,2020,5,0,1,1
62,2020,6,2,1,3
62,2020,7,1,0,1
62,2020,8,0,2,2
62,2020,9,2,3,5
62,2020,10,1,1,2
62,2020,11,2,1,3
62,2020,12,0,2,2
63,2020,2,1,0,1
63,2020,3,1,1,2
63,2020,6,0,1,1
63,2020,7,1,0,1
63,2020,8,0,1,1
63,2020,9,2,0,2
63,2020,10,3,2,5
63,2020,11,0,1,1
63,2020,12,1,1,2
64,2020,2,1,0,1
64,2020,6,1,1,2
64,2020,7,0,2,2
64,2020,9,0,3,3
64,2020,11,0,1,1
65,2020,2,0,1,1
65,2020,4,1,0,1
65,2020,7,1,1,2
65,2020,9,2,0,2
65,2020,10,0,2,2
66,2020,1,4,5,9
66,2020,2,5,8,13
66,2020,3,16,4,20
66,2020,4,5,7,12
66,2020,5,8,4,12
66,2020,6,10,9,19
66,2020,7,11,10,21
66,2020,8,18,10,28
66,2020,9,17,10,27
66,2020,10,25,12,37
66,2020,11,15,20,35
66,2020,12,16,14,30
67,2020,5,0,1,1
67,2020,6,1,1,2
67,2020,7,1,1,2
67,2020,8,1,0,1
67,2020,9,1,1,2
67,2020,10,0,1,1
67,2020,12,0,1,1
68,2020,1,0,1,1
68,2020,2,3,0,3
68,2020,3,2,1,3
68,2020,5,2,2,4
68,2020,6,0,4,4
68,2020,7,3,1,4
68,2020,8,2,1,3
68,2020,9,2,0,2
68,2020,11,3,3,6
68,2020,12,2,2,4
69,2020,1,2,0,2
69,2020,2,3,2,5
69,2020,3,2,6,8
69,2020,4,1,4,5
69,2020,5,3,1,4
69,2020,6,2,3,5
69,2020,7,5,6,11
69,2020,8,5,3,8
69,2020,9,6,3,9
69,2020,10,5,3,8
69,2020,11,5,3,8
69,2020,12,2,6,8
70,2020,1,5,4,9
70,2020,2,7,8,15
70,2020,3,7,7,14
70,2020,4,6,9,15
70,2020,5,7,6,13
70,2020,6,8,7,15
70,2020,7,6,7,13
70,2020,8,9,6,15
70,2020,9,4,7,11
70,2020,10,8,5,13
70,2020,11,10,6,16
70,2020,12,4,9,13
71,2020,1,10,9,19
71,2020,2,11,3,14
71,2020,3,11,8,19
71,2020,4,12,11,23
71,2020,5,14,9,23
71,2020,6,11,14,25
71,2020,7,8,17,25
71,2020,8,22,19,41
71,2020,9,24,17,41
71,2020,10,25,19,44
71,2020,11,15,29,44
71,2020,12,20,23,43
72,2020,1,14,7,21
72,2020,2,8,5,13
72,2020,3,14,9,23
72,2020,4,18,8,26
72,2020,5,5,4,9
72,2020,6,7,5,12
72,2020,7,5,10,15
72,2020,8,15,11,26
72,2020,9,11,10,21
72,2020,10,16,11,27
72,2020,11,11,9,20
72,2020,12,11,17,28
